#アジア
ANQ	= "countries/Asia.txt"	#安徽
BLI	= "countries/Asia.txt"	#バリ
CAL	= "countries/Asia.txt"	#カリフォルニア
CEN	= "countries/Asia.txt"	#中米連邦
DTN	= "countries/Asia.txt"	#大天帝国
ETR	= "countries/Asia.txt"	#東トルキスタン
FUJ	= "countries/Asia.txt"	#福建
GUG	= "countries/Asia.txt"	#広西軍閥
HNA	= "countries/Asia.txt"  #湖南軍閥
HYD	= "countries/Asia.txt"  #ハイデラバード
JPR	= "countries/Asia.txt"  #日本共和国
KUO	= "countries/Asia.txt"  #国民軍
MIN	= "countries/Asia.txt"  #大明
NAN	= "countries/Asia.txt"  #南京総督府
SAN	= "countries/Asia.txt"  #山西軍閥
YNN	= "countries/Asia.txt"	#雲南

#西欧
BAD	= "countries/Western Europe.txt"	#バーデン
BAL	= "countries/Western Europe.txt"	#バルト
ENR	= "countries/Western Europe.txt"	#ブリタニア
SIC	= "countries/Western Europe.txt"	#シチリア
TEX	= "countries/Western Europe.txt"	#テキサス
HES	= "countries/Western Europe.txt"	#ヘッセン
KIE	= "countries/Western Europe.txt"	#キール

#東欧
GAL	= "countries/Eastern Europe.txt"	#ガリツィア・ロドメリア
RUS	= "countries/Eastern Europe.txt"	#ロシア(ソビエト)
SIB	= "countries/Eastern Europe.txt"	#シベリア

#アフリカ
ESA	= "countries/Africa.txt"	#日本領ソマリ
ETO	= "countries/Africa.txt"	#エチオピア
KAT	= "countries/Africa.txt"	#カタンガ
KIS	= "countries/Africa.txt"	#キサンガニ(新朝鮮)
KIV	= "countries/Africa.txt"	#キヴ
MAU	= "countries/Africa.txt"	#マウマウ団
SKT	= "countries/Africa.txt"	#ソコト


#南米
AMZ	= "countries/South America.txt"	#アマゾナス
BRR	= "countries/South America.txt"	#ブラジル合衆国
SPO	= "countries/South America.txt"	#サンパウロ